1111111111111111111111111111111111
1E0000000000000C00000C000000000001
1010010000100000101001000000010101
1010010010101010001000000001010001
1P00000C00C0000000000000000000C011
1111111111111111111111111111111111